NO textures/wall_1.png
SO textures/wall_2.png
WE textures/wall_3.png
EA textures/wall_4.png
F 166,142,114
C 135,206,250


1111111111111111111111111
1000000000110000000000001
1011000001000000000000001
10010000000W100000000000111111111
111111111000000001110000000000001
100000000011000001110111111111111
11110111111111011100000010001
111111111111111111111111111111




1111111
1111101
10000001
1111111