NO textures/wall_1.png
SO textures/wall_2.png
WE textures/wall_3.png
EA textures/wall_4.png
F 166,142,114
C 135,206,250

1111111111111111111111111
1000000000110000000000001
1011000001000000000000001
10010000000W1000000000001
1111111110000000011100001
1000000000110000011101111
1111011111111101110000001
1111111111111111111111111

