NO textures/wall_1.png
SO textures/wall_2.png
WE textures/wall_3.png
EA textures/wall_4.png
F 166,142,114
C 135,206,250

111111111
111111111
1100P000111111
111111111
110000001
111111111