11111111111111111111111111111111111111111111111111111111111111
1P100001000000100000000000000000000000010000000000000100000001
10100001000000000000000000000000000000010000000000000010000001
10000001000C00100000000000000000000000010000000000000000100001
10000001000C00100000000000000000000000010000000000010000000001
10000001000C00100000000000000000000000010000000001000001000001
10000001000C00100000000000000000000000010000000001000001000001
1C10C000000000100001C10C00000000010000010000000001000001000001
1C10C000000000100001C10C00000000010000010000000001000001000001
1C10C000000000100001C10C00000000010000010000000001000001000001
1C10C000000000100001C10C00000000010000010000000001000001000001
1C10C00000000010E001C10C00000000010000010000000001000001000001
11111111111111111111111111111111111111111111111111111111111111
